Name the Video Game this quote is from: “War. War never Changes” 	## Fallout						
Name the Video Game this quote is from: “The cake is a lie”	## Portal						
Name the Video Game this quote is from: “You have died of dysentery” 	## Oregon Trail						
Name the Video Game this quote is from: “Stay awhile and listen!” 	## Diablo						
Name the Video Game this quote is from: “You require more vespene gas” and “Not Enough Minerals” 	## StarCraft						
Name the Video Game this quote is from: “A man chooses! A slave obeys!”	## BioShock						
Name the Video Game this quote is from: “Frostmourne hungers” 	## WarCraft III	## Warcraft	## Warcraft 3				
Name the Video Game this quote is from: “Kirov Reporting” 	## Red Alert 2	## Red Alert					
Name the Video Game this quote is from: “What do the numbers mean, Mason?” 	## Call of duty	## black ops	## call of duty: black ops				
Name the Video Game this quote is from: "We all make choices in life, but in the end our choices make us."	## BioShock						
Name the Video Game this quote is from: "Get over here!" 	## Mortal Kombat						
Name the Video Game this quote is from: "What is better? To be born good or to overcome your evil nature through great effort?" 	## Skyrim	## elder scrolls	## elder scrolls: skyrim				
Name the Video Game this quote is from: "The right man in the wrong place can make all the difference in the world."	## Half-Life	## Half Life	## Half Life 2	## Half-Life 2			
Name the Video Game this quote is from: "Stand in the ashes of a trillion dead souls, and asks the ghosts if honor matters. The silence is your answer." 	## Mass Effect 3	## Mass Effect					
Name the Video Game this quote is from: "Bring me a bucket, and I'll show you a bucket!"	## Borderlands	## Borderlands 2	
Name the Video Game this quote is from: "Even in dark times, we cannot relinquish the things that make us human."	## Metro 2033						
Name the Video Game this quote is from: "How many are there in you? Whose hopes and dreams do you encompass? Could you but see the eyes in your own, the minds in your mind, you would see how much we share."	## Half-Life	## Half Life	## Half Life 2	## Half-Life 2			
Name the Video Game this quote is from: "The healthy human mind doesn't wake up in the morning thinking this is its last day on Earth. But I think that's a luxury, not a curse. To know you're close to the end is a kind of freedom. Good time to take... inventory."	## Call of duty	## Modern Warfare	## call of duty: Modern Warfare	## Modern Warfare 2	## call of duty: modern warfare 2		
Name the Video Game this quote is from: "It’s a funny thing, ambition. It can take one to sublime heights or harrowing depths. And sometimes they are one and the same."	## Dishonored						
Name the Video Game this quote is from: "A hero need not speak. When he is gone, the world will speak for him."	## Halo						
Name the Video Game this quote is from: "No gods or kings. Only man."	## BioShock						
Name the Video Game this quote is from: "Some trees flourish, others die. Some cattle grow strong, others are taken by wolves. Some men are born rich enough and dumb enough to enjoy their lives. Ain’t nothing fair."	## red dead redemption						
Name the Video Game this quote is from: "You can’t break a man the way you break a dog, or a horse. The harder you beat a man, the taller he stands."	## far cry	## far cry 2					
Name the Video Game this quote is from: "It's time to kick ass and chew bubblegum... and I'm all outta gum."	## duke nukem	## duke nukem 3d					
Name the Video Game this quote is from: "Life is cruel. Of this I have no doubt. One can only hope that one leaves behind a lasting legacy. But so often, the legacies we leave behind...are not the ones we intended."	## gears of war	## gears of war 2					
Name the Video Game this quote is from: “…” 	## zelda	## legends of zelda	## the legends of zelda				
Name the Video Game this quote is from: "If our lives are already written, it would take a courageous man to change the script." 	## alan wake						
Name the Video Game this quote is from: "It's easy to forget what a sin is in the middle of a battlefield."	## metal gear solid						
Name the Video Game this quote is from: "You know, being Caroline taught me a valuable lesson. I *thought* you were my greatest enemy, when all along you were my best friend. The surge of emotion that shot through me when I saved your life taught me an even more valuable lesson - where Caroline lives in my brain."	## portal	## Portal 2					
Name the Video Game this quote is from: "The courage to walk into the Darkness, but strength to return to the Light."	## destiny						
Name the Video Game this quote is from: "Who are you, that do not know your history?"	## Fallout	## fallout new vegas	## new vegas				
Name the Video Game this quote is from: "Don't wish it were easier, wish you were better."	## animal crossing						
Name the Video Game this quote is from: "The world fears the inevitable plummet into the abyss. Watch for that moment and when it comes, do not hesitate to leap. It is only when you fall that you learn whether you can fly."	## Dragon Age	## Dragon Age origins 					
Name the Video Game this quote is from: "Most test subjects do experience some cognitive deterioration after a few months in suspension. Now you've been under for... quite a lot longer, and it's not out of the question that you might have a very minor case of serious brain damage. But don't be alarmed, alright? Although, if you do feel alarm, try to hold onto that feeling because that is the proper reaction to being told you have brain damage." 	## portal	## Portal 2					
Name the Video Game this quote is from: "Trust me." BT-7274	## titanfall	## Titanfall 2					
Name the Video Game this quote is from: "If history only remembers one in a thousands of us, then the future will be filled with stories of who we were and what we did." 	## battlefield	## Battlefield 1					
Name the Video Game this quote is from: "We're made up of thousands of parts with thousands of functions all working in tandem to keep us alive. Yet if only one part of our imperfect machine fails, life fails. It makes one realize how fragile, how flawed we are." 	## Skyrim	## elder scrolls	## elder scrolls: skyrim				
Name the Video Game this quote is from: "Nothing is true, everything is permitted." E	## Assassin’s Creed 2	## Assassin’s Creed					
Name the Video Game this quote is from: "Good men mean well. We just don't always end up doing well." 	## dead space	## dead space 3					
Name the Video Game this quote is from: "It’s dangerous to go alone, take this!" 	## zelda	## legends of zelda	## the legends of zelda				
Name the Video Game this quote is from: "War. War never changes."	## Fallout	## Fallout 3					
Name the Video Game this quote is from: "AAAAAAAAAAAAHHHRHGHHHGH thump"	## elder  scrolls	## elder scrolls 3	## morrowind				
Name the Video Game this quote is from: "The best solution to a problem is usually the easiest one. And I'll be honest - killing you is hard. You know what my days used to be like? I just tested. Nobody murdered me, or put me in a potato, or fed me to birds. I had a pretty good life. And then you showed up. You dangerous, mute lunatic. So you know what? You win. Just go. [chuckles] It's been fun. Don't come back." 	## portal	## Portal 2					
Name the Video Game this quote is from: "Boss... you were right. It's not about changing the world. It's about doing our best to leave the world... the way it is. It's about respecting the will of others, and believing in your own."	## metal gear solid	## metal gear solid 4					
Name the Video Game this quote is from: "Often when we guess at others' motives, we reveal only our own." 	## destiny						
Name the Video Game this quote is from: "Endure and survive." 	## the last of us						
Name the Video Game this quote is from: "Death is inevitable. Our fear of it makes us play safe, blocks out emotion. It's a losing game. Without passion, you are already dead." 	## max payne	## max payne 2	## max payne 2: the fall of max payne				
Name the Video Game this quote is from: "You gave them the one thing that was stolen from them. A chance. A chance to learn. To find love. To live. And in the end what was your reward? You never said. But I think I know: a family."	## BioShock						
Name the Video Game this quote is from: "Protocol one: link to Pilot. Protocol two: uphold the mission. Protocol three: protect the Pilot." 	## titanfall	## Titanfall 2					
Name the Video Game this quote is from: "You are here, and it’s beautiful, and escaping isn’t always something bad." 	## firewatch						
Name the Video Game this quote is from: "You can’t undo what you’ve already done, but you can face up to it."	## silent hill	## silent hill: downpour					
Name the Video Game this quote is from: "I miss the internet"	## Left 4 dead	## left for dead					
Name the Video Game this quote is from: "Life is all about resolve. Outcome is secondary."	## okami						
Name the Video Game this quote is from: "Stay awhile, and listen!"	## Diablo	## Diablo 2	## diablo II				
Name the Video Game this quote is from: "Thank you Mario! But our Princess is in another castle!"	## mario	## super mario	## super mario bros				
Name the Video Game this quote is from: "I WILL KILL YOUR DICKS!" 	## bulletstorm						
Name the Video Game this quote is from: "What is a man? A miserable little pile of secrets." 	## castlevania	## castlevania: symphony of the night					
Name the Video Game this quote is from: "My brothers and sisters... I will see you again. Someday. You've given them back to me.	## destiny						
Name the Video Game this quote is from: “…” *cocks shotgun*	## doom						
Name the Video Game this quote is from: "Finish him!"	## Mortal Kombat						
Name the Video Game this quote is from: "A man chooses; a slave obeys." 	## BioShock						
Name the Video Game this quote is from: "We both said a lot of things that you're going to regret. But I think we can put our differences behind us. For science. You monster."	## portal						
Name the Video Game this quote is from: "Snake? Snake? SNAAAAAAAAKE!!!"	## metal gear solid	## metal gear solid 2					
Name the Video Game this quote is from: "Wake me when you need me."	## halo	## Halo 3					
Name the Video Game this quote is from: "Grass grows, birds fly, sun shines, and brother, I hurt people." 	## team fortress	## team fortress 2					
Name the Video Game this quote is from: "Every puzzle has an answer."	## Professor Layton and the Curious Village						
Name the Video Game this quote is from: "Hey! Listen!" 	## ocarina of time	## zelda	## legends of zelda	## the legends of zelda	## zelda	## the legends of zelda	## legends of zelda
Name the Video Game this quote is from: "I used to be an adventurer like you, until I took an arrow to the knee." 	## elder  scrolls	## skyrim					
Name the Video Game this quote is from: "It’s super effective!" 	## pokemon						
Name the Video Game this quote is from: "The Kid just rages for a while." 	## bastion						
Name the Video Game this quote is from: "Space. Space. I'm in space. SPAAAAAAACE!"	## portal	## Portal 2					
Name the Video Game this quote is from: "The ending isn’t any more important than any of the moments leading to it."	## to the moon						
Name the Video Game this quote is from: "Do a barrel roll!" 	## star fox	## star fox 64					
Name the Video Game this quote is from: "I’m rackin' my brain trying to think of a name for that diamond pony I bought. I was gonna call it “piss-for-brains” in honor of you, but that just feels immature. Maybe...”Butt Stallion”?" 	## Borderlands	## Borderlands 2					
Name the Video Game this quote is from: "No matter how dark the night, morning always comes, and our journey begins anew." 	## final fantasy	## final fantasy 10	## final fantasy x				
Name the Video Game this quote is from: "Hope is what makes us strong. It is why we are here. It is what we fight with when all else is lost." 	## god of war	## god of war 3					
Name the Video Game this quote is from: "Steel wins battles. Gold wins wars." 	## dota	## Dota 2					
Name the Video Game this quote is from: "War. War never changes. But men do, through the roads they walk." 	## Fallout	## fallout new vegas					
Name the Video Game this quote is from: "Science isn’t about why! It’s about why not!" 	## portal	## Portal 2					
Name the Video Game this quote is from: "There was a HOLE here. It's gone now."	## silent hill	## silent hill 2					
Name the Video Game this quote is from: "I don’t want to set the world on fire…"	## Fallout	## Fallout 3					
Name the Video Game this quote is from: "Hard to see big picture behind pile of corpses."	## Mass Effect 3	## Mass Effect					
Name the Video Game this quote is from: "Does this unit have a soul?" 	## Mass Effect 3	## Mass Effect					
Name the Video Game this quote is from: "You are not a good person. You know that, right? Good people don't end up here." 	## portal	## Portal 2					
Name the Video Game this quote is from: "Federico: It is a good life we lead, brother. Ezio: The best. May it never change. Federico: And may it never change us." 	## Assassin’s Creed 2	## Assassin’s Creed					
Name the Video Game this quote is from: "I raised you, and loved you, I've given you weapons, taught you techniques, endowed you with knowledge. There's nothing more for me to give you. All that's left for you to take is my life."	## metal gear solid	## metal gear solid 3					
Name the Video Game this quote is from: "It's more important to master the cards you're holding than to complain about the ones your opponents were dealt." 	## pokemon	## pokemon black and white	## black and white				
Name the Video Game this quote is from: "Are you a boy or a girl?"	## pokemon						
Name the Video Game this quote is from: "LOTTA PEOPLE BEEN ASKIN' WHY MY VOICE BEEPS ALL THE TIME. THE TORGUE SHAREHOLDERS WIRED MY VOICEBOX WITHA DIGITAL CENSOR SO I CAN'T SAY 
LIKE SH*T, C*CK, OR P*SSY F*CKIN' D*CKBALLS! THATS HALF MY F*CKIN' VOCABULARY, IT'S GODDAMN BULLSH*T!" 	## Borderlands	## Borderlands 2					
Name the Video Game this quote is from: "When life gives you lemons, don't make lemonade. Make life take the lemons back! Get mad! I don't want your damn lemons! What am I supposed to do with these?! Demand to see life's manager! Make life rue the day it thought it could give Cave Johnson lemons! Do you know who I am?! I'm the man who's gonna burn your house down! With the lemons! I'm gonna get my engineers to invent a combustible lemon that burns your house down!"	## portal	## Portal 2					
Name the Video Game this quote is from: "Praise the sun!" 	## dark souls						
Name the Video Game this quote is from: "Send me out...with a bang."	## halo	## Halo 3					
Name the Video Game this quote is from: "Ghost: This path should lead us straight to the grave. [pause] Ghost: The World's Grave. Not ours."	## destiny						
Name the Video Game this quote is from: "I've struggled a long time with survivin', but no matter what you have to find something to fight for." 	## the last of us						
Name the Video Game this quote is from: "You are the bad guy, and I'll show you how this system deals with bad guys!" ## A Hat In Time ## Hat in Time ## AHiT
Name the Video Game this quote is from: "DAMN YOU AND YOUR EMPIRE!" ## Galak-Z ## Galak Z
Name the Video Game this quote is from: "Let's climb out of here, together." # Celeste
Name the Video Game this quote is from: "This is the story, of a man named Stanley." ## The Stanley Parable ## Stanley Parable
Name the Video Game this quote is from: "ELEEEEEEIIIIISEEEEEEEE!" ## Sonic 06 # Sonic 2006 ## Sonic The Hedgehog
Name the Video Game this quote is from: "Yes. You failed. But... there is one more thing I would like to conduct. Electricty. Through you." ## Lego Dimensions
Name the Video Game this quote is from: "Hello, my name is doctor Glenn Pierce, and I'd like to talk to you about being special." ## Superliminal ## Super liminal
Name the Video Game this quote is from: "Your life will always be a struggle, and you will always have problems." ## Superliminal ## Super liminal
Pac-Man ghost enemies are dubbed Blinky, Pinky and Inky. What is the name of the fourth member of the crew?	##  Clyde	
Pac-Man ghost enemies are dubbed Blinky, Pinky and clyde. What is the name of the fourth member of the crew?	##  inky	
What is the only videogame franchise originating in the 1970's to have thus far generated over $1 billion in revenue?	##  Space Invaders 	
What was the name of the long-standing official Nintendo strategy magazine?	##  Nintendo Power 	
Which Mario character has appeared in all but one "Mario Party" game?	##  Wario 	
Which videogame console did Nintendo release directly prior to the Wii?	##  gamecube	
What type of animal is Sonic's companion "Knuckles"?	##  Echidna 	
What is the name of the hero from "Mike Tyson's Punch-Out"?	##  Little Mac 	
Which videogame is generally considered to be the original third-person shooter?	##  Wolfenstein 3D 	##  Wolfenstein 
The "Kingdom Hearts" videogame series is a collaboration between Disney and what famous gaming company?	##  Square Enix 	
Which character in the "Street Fighter" series was inspired by martial-arts legend Bruce Lee?	##  Fei Long 	
What classic videogame did Tony Stark catch a member of S.H.I.E.L.D. playing in the first "Avengers" movie?	##  Galaga 	
The Nintendo Game Boy utilized which type of display system?	##  LCD 	
What is the name of the final course in all "Mario Kart" videogames?	##  Rainbow Road 	
Which real-life talk-show host is a radio personality in "Grand Theft Auto"?	##  Lazlow Jones 	
Which "Mortal Kombat" character has the ability to transform into a dragon?	##  Liu Kang 	
What was the first videogame console with a CD-ROM embedded into it?	##  3DO 	
What videogame featured the first Easter egg?	##  Adventure 	
Nintendo began as a company selling which products?	##  Playing cards 	## cards
What is the name of the peripheral device that can be plugged into a Nintendo 64 controller to make it vibrate?	##  Rumble Pak 	
What color do the ghost enemies turn to once Pac-Man eats a Power Pellet?	##  Blue 	
Ed Boon and John Tobias are the original designers of which renowned videogame franchise?	##  Mortal Kombat 	
Characters in videogames who cannot be outrightly controlled by players are acronymed as what?	##  NPCs	## NPC
What are the professions of Mario and his brother Luigi?	##  Plumbers 	
Mario originated as a character in which classic videogame?	##  Donkey Kong 	
What is the name of the primary world upon which the "World of Warcraft" takes place?	##  Azeroth 	
Who provides the voice of Pikachu in the 2019 "Pokémon: Detective Pikachu" movie?	##  Ryan Reynolds 	
Which movie did Dwayne "the Rock" Johnson star in that was based on a videogame?	##  Doom 	
The name of Sonic's sidekick.	##  Tails 	
The antagonist in the Legend of Zelda.	##  Gannon 	
The original name of Super Mario. 	##  Jumpman 	
The console created by Sega named after a planet. 	##  Saturn 	
Classic puzzle game with a Russian theme and music.	##  Tetris 	
Popular Role Playing Game (RPG) series by Square Enix that just reached it's 15th instalment 	##  Final Fantasy 	
Character created by NAMCO that eats pellets, fruits and ghosts. 	##  Pacman 	
The name of Mega Man's sister. 	##  roll	
An FPS (First person shooter) created by Blizzard that features characters such as Zarya, Soldier: 76 and Bastion. 	##  Overwatch 	
What does DOTA stand for	##  defence of the ancients	
In the game Destiny, the name of the guardian's companions built from Machinery and the Traveler's light. 	##  Ghosts 	## ghost
Name the seventh planet from the sun 	##  Uranus 	
How many Gym Badges must a trainer collect before challenging the Elite Four?	##  8	## eight
What type of Pokemon does Gym Leader Erika specialize in?	##  grass	
What type of move is Gyarados 4 times weak against?	##  Electric	
What region is the setting for Pokemon Ruby/Sapphire/Emerald?	##  Hoenn	
What's Larvitar's fully evolved form?	##  Tyranitar 	
Who is the god of all Pokemon?	##  Arceus 	
What weather condition does Kyogre summon upon entering battle?	##  Rain 	
What Pokemon can be resurrected from the Helix Fossil?	##  Omanyte	
What Pokemon can be resurrected from the Old Amber?	##  aerodactly	
How many shapes/forms can Unown be? 	##  28	
AMONG ALL, WHICH POKEMON CAN USE THE PRIMAL EVOLUTION? 	##   Groudon	## Kyogre
NAME THE POKEMON WHICH LIVES IN A REVERSE DIMENSION? 	##  Giratina	
THE FIRST WORD MEOWTH EVER LEARNED WAS? 	##   Rocket 	
What was Bowser's original name?	## King Koopa	
What was Princess Peach's original name?	## Princess Toadstool	
What does the P-Wing stand for in the games?	## Paratroopa Wing	
Which character is not a Koopaling? Lemmy, Roy, Iggy, or Sid?	## Sid	
Who is in love with Sonic? 	## Amy 	
What is Sonic's favorite food? 	## Chilly Dogs 	## Chili Dogs
What is Sonic's secret hobby? 	## DJ ## Break dancing ## Breakdancing ## Disk Jockey 	
Which movie includes the line“What are you telling me? That I can dodge bullets?"	## matrix	## the matrix
“In space, no one can hear you scream"is the tagline for which classic film starring Sigourney Weaver?	## Alien	
What is the license plate of the DeLorean in the Back to the Future films?	## 88timego 	
What is the name of the fifth element in The Fifth Element?	## Leeloo 	
“Dazzle” is a term used for a group of what type of animal?	## Zebra 	
What planet’s moons are nearly all named after Shakespearean characters?	## Uranus 	
Lily Tomlin voiced Ms. Frizzle in the cartoon adaptation of what educational book series?	## Magic School Bus 	## The Magic School Bus
What type of number has no factors other than 1 and itself?	## Prime Number 	
On the periodic table of elements, which element has the shortest name?	## Tin 	
In Darts, what is the highest possible score using three darts?	## 180	
When used on the internet, what does IIRC mean?	## If I recall correctly	
Who wrote The Hitchhiker’s Guide to the Galaxy books? 	## Douglas Adams 	
How many books are there in the Hitchhiker's trilogy? 	## 5	
What is the Pan Galactic Gargle Blaster 	## drink	## a drink
Which Mario Kart game was NOT made by Nintendo ## Mario Kart Arcade GP ## Mario Kart Arcade ##MKAGP
What Primal Evolution Pokemon can NEVER be obtained through normal means? ##Dialga ##Primal Dialga
How many levels are in the game Pac-Man? ##256 ##Two Hundred and Fifty Six ##Two Hundred Fifty Six
Who was the creator of the game Rez? ##Tetsuya Mizuguchi ## Tetsuya ## Mizuguchi
What was the first game Sonic the Hedgehog appeared in? ## Rad Mobile
What Pokémon does this Pokédex entry  belong to: It remembers every dream it eats. It rarely eats the dreams of adults because children's are much tastier. 	##  Drowzee
What Pokémon does this Pokédex entry  belong to: The spirits it absorbs fuel its baleful fire. It hangs around hospitals waiting for people to pass on. 	##  Lampent
What Pokémon does this Pokédex entry  belong to: Each of them carries a mask that used to be its face when it was human. Sometimes they look at it and cry. 	##  yamask
What Pokémon does this Pokédex entry  belong to: Although this Pokémon is the very picture of elegance and beauty while swimming, it is also cruel. When it spots prey, this Pokémon inserts its thin mouth into the prey's body and drains the prey of its body fluids. 	##  Gorebyss
What Pokémon does this Pokédex entry  belong to: It is whispered that any child who mistakes this pokemon for a balloon and holds on to it could wind up missing. 	##  Drifloon
What Pokémon does this Pokédex entry  belong to: If a traveller is going through a desert in the thick of night, this Pokémon will follow in a ragtag group. The Pokémon are biding their time, waiting for the traveler to tire and become incapable of moving. 	##  Cacturne
What Pokémon does this Pokédex entry  belong to: Its tongue is made of gas. If licked, its victim starts shaking constantly until death eventually comes. 	##  Haunter
What Pokémon does this Pokédex entry  belong to: An abandoned plush doll became this Pokémon. They are said to live in garbage dumps and wander about in search of the children that threw them away 	##  Banette
What Pokémon does this Pokédex entry  belong to: If anyone dares to grab its hilt, it wraps a blue cloth around that person's arm and drains that person's life energy completely 	##  Honedge
What Pokémon does this Pokédex entry  belong to: According to old tales, these Pokémon are stumps possessed by the spirits of children who died while lost in the forest 	##  Phantump
What Pokémon does this Pokédex entry  belong to: It en-wraps its prey in its hair like arms. It sings joyfully as it observes the suffering of its prey 	##  Gourgeist
What Pokémon does this Pokédex entry  belong to: When its life comes to an end, it absorbs the life energy of every living thing and turns into a cocoon once more. 	##  Yveltal
What Pokémon does this Pokédex entry  belong to: This Pokemon droppings are hot, so people used to put them in their clothes to keep themselves warm. 	##  Darumaka
What Pokémon does this Pokédex entry  belong to: This Pokémon has the habit of hugging its companions. Many Trainers have left this world after their spines were squashed by its hug. 	##  Bewear
What Pokémon does this Pokédex entry  belong to: This Pokémon  brain is very small. It is so dense, while on a run it forgets why it started running in the first place. It apparently remembers sometimes if it demolishes something.	##  Rhyhorn
What Pokémon does this Pokédex entry  belong to: Virtually worthless in terms of both power and speed. It is the most weak and pathetic Pokémon in the world. 	##  Magikarp
What Pokémon does this Pokédex entry  belong to: If a child it has made friends with is bullied, Drampa will find the bully's house and burn it to the ground. 	##  Drampa 
What Pokémon does this Pokédex entry  belong to: It is born asleep, and it dies asleep. All its movements are apparently no more than the results of it tossing and turning in its dreams 	##  Komala
What Pokémon does this Pokédex entry  belong to: It freezes hikers who have come to climb snowy mountains and carries them back to its home. It only goes after men it thinks are handsome. 	##  Froslass
What Pokémon does this Pokédex entry  belong to: To protect its Trainer, it will expend all its psychic power to create a small black hole 	##  Gardevoir
What Pokémon does this Pokédex entry  belong to: For some reason, it likes to land on people's heads softly and act like it's a hat. 	##  Swablu
What Pokémon does this Pokédex entry  belong to: If it bonds with a person, it will gently envelop the friend with its soft wings, then hum 	##  Altaria
What Pokémon does this Pokédex entry  belong to: It apparently wishes for a traveling companion. Since it was once human itself, it tries to create one by taking the lives of other humans. ##  Gengar
What Pokémon does this Pokédex entry  belong to: A touch from anyone except a known friend sends it into a surging frenzy. It's an incredibly dangerous Pokémon. ##  Stufful
What Pokémon does this Pokédex entry  belong to: Its shell is filled with its soft innards. It doesn't move much because of the risk it might carelessly spill its innards out. ##  Metapod
What Pokémon does this Pokédex entry  belong to: Stories go that it grabs the hands of small children and drags them away to the afterlife. It dislikes heavy children. ## Drifloon
In Mortal Kombat 3, which character’s Animality was a  Vulture	##  Baraka
In Mortal Kombat 3, which character’s Animality was a  Shark	##  Cyrax
In Mortal Kombat 3, which character’s Animality was a  Frog	##  Ermac
In Mortal Kombat 3, which character’s Animality was a  Cat	##  Jade
In Mortal Kombat 3, which character’s Animality was a  Lion	##  Jax
In Mortal Kombat 3, which character’s Animality was a  Kangaroo	##  Johnny Cage
In Mortal Kombat 3, which character’s Animality was a  Rhinoceros 	##  Kabal  
In Mortal Kombat 3, which character’s Animality was a  Giant Tarantula  	##  Kano  
In Mortal Kombat 3, which character’s Animality was a  Rabbit  	##  Kitana 
In Mortal Kombat 3, which character’s Animality was a  Cheetah  	##  Kung Lao 
In Mortal Kombat 3, which character’s Animality was a  Dragon  	##  Liu Kang  
In Mortal Kombat 3, which character’s Animality was a  Skunk 	##  Mileena 
In Mortal Kombat 3, which character’s Animality was a  Wolf 	##  Nightwolf  
In Mortal Kombat 3, which character’s Animality was an Anteater  	##  Noob Saibot 
In Mortal Kombat 3, which character’s Animality was an  Electric eel 	##  Raiden 
In Mortal Kombat 3, which character’s Animality was a  Small Elephant 	##  Rain  
In Mortal Kombat 3, which character’s Animality was a  Chimpanzee  	##  Reptile 
In Mortal Kombat 3, which character’s Animality was a  Penguin 	##  Scorpion 
In Mortal Kombat 3, which character’s Animality was a  Giant Bat  	##  Sektor  
In Mortal Kombat 3, which character’s Animality was a  Cobra  	##  Shang Tsung  
In Mortal Kombat 3, which character’s Animality was a  Giant Scorpion 	##  Sheeva 
In Mortal Kombat 3, which character’s Animality was a  Giant Hornet 	##  Sindel  
In Mortal Kombat 3, which character’s Animality was a  Bull 	##  Smoke 
In Mortal Kombat 3, which character’s Animality was a  Porcupine  	##  Smoke 
In Mortal Kombat 3, which character’s Animality was a  Hawk 	##  Sonya Blade  
In Mortal Kombat 3, which character’s Animality was a  Tyrannosaurus Rex 	##  Stryker  
In Mortal Kombat 3, which character’s Animality was a  Polar Bear 	##  Sub-Zero  
In Mortal Kombat Trilogy, which character “Gives their opponent a birthday gift.“ as their Friendship Fatality?	##  Baraka 
In Mortal Kombat Trilogy, which character “Gives an autographed photo, which reads "To my best fan!” “ as their Friendship Fatality?	##  Johnny Cage 
In Mortal Kombat Trilogy, which character “Covers themselves up in a snowman “ as their Friendship Fatality?	##  Sub-Zero 
In Mortal Kombat Trilogy, which character “Dances the Charleston “ as their Friendship Fatality?	##  Cyrax 
In Mortal Kombat Trilogy, which character “levitates the opponent who then transforms into a rabbit “ as their Friendship Fatality?	##  Ermac 
In Mortal Kombat Trilogy, which character “Pogo-jumps with their staff “ as their Friendship Fatality?	##  Jade 
In Mortal Kombat Trilogy, which character “Skips rope “ as their Friendship Fatality?	##  Jax
In Mortal Kombat Trilogy, which character “Uses one of their hookswords to roast a marshmallow “ as their Friendship Fatality?	##  Kabal 
In Mortal Kombat Trilogy, which character “Blows a bubble with gum, and it pops on their face “ as their Friendship Fatality?	##  Kano 
In Mortal Kombat Trilogy, which character “Blows bubbles at the opponent. “ as their Friendship Fatality?	##  Kitana 
In Mortal Kombat Trilogy, which character “Throws their hat off-screen like a Frisbee while a dog follows it to fetch “ as their Friendship Fatality?	##  Kung Lao 
In Mortal Kombat Trilogy, which character “makes a shadow puppet of the MK dragon symbol “ as their Friendship Fatality?	##  Liu Kang 
In Mortal Kombat Trilogy, which character “Looks at their unmasked face at a mirror, which shatters “ as their Friendship Fatality?	##  Mileena 
In Mortal Kombat Trilogy, which character “Performs a Raidentransformation, as a Mortal Kombat II arcade falls from the sky behind him “ as their Friendship Fatality?	##  Nightwolf 
In Mortal Kombat Trilogy, which character “Goes bowling, getting a split. Shao Kahn is heard saying "That was pathetic" afterwards “ as their Friendship Fatality?	##  Noob Saibot 
In Mortal Kombat Trilogy, which character “Summons raindrops “ as their Friendship Fatality?	##  Rain 
In Mortal Kombat Trilogy, which character “Hits a strength testing pole with a mallet, causing the bell to ring. “ as their Friendship Fatality?	##  Sektor 
In Mortal Kombat Trilogy, which character “Turns into the main character of the retro game Joust. “ as their Friendship Fatality?	##  Shang Tsung 
In Mortal Kombat Trilogy, which character “Spins plates on sticks held with each of their hands “ as their Friendship Fatality?	##  Sheeva 
In Mortal Kombat Trilogy, which character “Kicks a football and states, "That was fun!" “ as their Friendship Fatality?	##  Sindel 
In Mortal Kombat Trilogy, which character “Blows a loud horn produced from their chest plate “ as their Friendship Fatality?	##  Smoke 
In Mortal Kombat Trilogy, which character “A sign that reads "No Smoking" falls from the sky, causing their own smoke emission to cease, then looks at the ground and says, "Aw..." “ as their Friendship Fatality?	##  Smoke 
In Mortal Kombat Trilogy, which character “A row of flowers grow from the ground near their feet. “ as their Friendship Fatality?	##  Sonya blade  
